text	label
It is essentially a resume , but targeted to the PEO , following the guidelines which they send you .	send_resume
[PERSON] , I sent myself a fax from the fax machine in the break area and it arrived about 10 minutes later in my inbox .	send_fax
Can I ask someone to send me a typical sales presentation , just so I can feel conversant with your positioning and pitch .	send_presentation
Please review this document by Tuesday and send your edits / feedback to me .	send_review
Hi [PERSON] , Here are the login instructions for our REHEARSAL session on 05/07/02 @ 3:00pm PT , please forward to the presenters . URL : http://www.placeware.com/cc/esdevents enter your full name Meeting ID : placeware Meeting Key : mademo Audio : 1 - 800 - 251 - 6413 PIN : 360820 Please send me a copy of your draft slide and I will upload them into the console before the rehearsal .	send_presentation
[PERSON] , Nothing has changed since the last time I sent these to you .	send_update_changes
btw , you never sent me those digital pics you took the last time I visited .	send_pictures
Send us an email at feedback@anyday.com .	send_review
Here I am sending my resume as attachment as per your suggestion .	send_resume
November 9 , 2000 GOLFLOGIX - BUSINESS UPDATES We will be sending you these periodic updates to keep you informed on GolfLogix activities .	send_update_changes
I 've sent the presentation and bio ; the only thing missing is the checklist ( a / v and lunch ) simply because I never received one .	send_presentation
If you have any last minute changes as to what is currently in use , please send the change to me .	send_update_changes
Please look it over and send me any questions or comments !	send_review
You can view the photo immediately on your computer , send it as e - mail or print it out on a Kodak Personal Picture Maker printer .	send_pictures
[PERSON] [PERSON] [PERSON] Could you please send me the most representative presentations on the enterprise strategy ?	send_presentation
This quarter 's news goes to [PERSON] at : pete@stanfordalumni.org Please send any photos ( with a caption and indication of whether you would like the photo returned ) directly to : [PERSON] [PERSON] Stanford Graduate School of Business News and Publication Department Stanford , [LOCATION] 94305 - 5015 Phone : 650 - 725 - 3241 Thanks , [PERSON] and [PERSON] ... _ _ _ _ _ _ _ _ _ _ _ _ _ _ _ _ _ _ _ _ _ _ _ _ _ _ _ _ _ _ _ _ _ _ _ _ _ _ _ _ _ _ _ _ _ _ _ _ _ _ _ _ _ _ _ _ _ _ _ _ _ _ _ _ _ _ _ _ _ _ _ _ Get Your Private , Free E - mail from MSN Hotmail at http://www.hotmail.com	send_pictures
I am pleased to send my resume , if your interest meets .	send_resume
Please review and send your comments .	send_review
Thanks and I 'll send more feedback tonight .	send_review
Now you can send faxes , email , and link directly to your inbox to receive all your messages . PC - to - Phone software version 3.1 lets you customize with a variety of styles .	send_fax
[PERSON] , please send the presentation .	send_presentation
Please modify your presentation for alignment and send the two presentations together or get [PERSON] to do it .	send_presentation
[PERSON] , I believe I put this in my outbox and asked you to send it to Saroya for a quick review .	send_review
I will send out another update shortly .	send_update_changes
I have asked [PERSON] to modify the AST and then have [PERSON] and [PERSON] review it before sending it to Accenture .	send_review
Users with camera - equipped handsets take pictures of themselves , their surroundings , families , pets ( and considering the proliferation of dating services in [LOCATION] , they are probably also taking pictures that we really do nt want to know about ) and sending them to other mobile users on J - phone s 2.5 G network .	send_pictures
Cam indicated to send presentation directly to [PERSON] and copy cam in	send_presentation
If you know someone , please send their resume to [PERSON] [PERSON] , Technical Recruiting Manager .	send_resume
Please send me feedback as soon as you can .	send_review
Please do not send EMAIL for changes - This may > delay service !	send_update_changes
class=101525918 - 05122002 > p.s.&nbsp ; [PERSON] and [PERSON] , can you please send me any pics you have of JC , [PERSON] , Me or Michael.&nbsp ; I 'll do the same for you guys.</SPAN></FONT></P></BODY></HTML > ------_=_NextPart_001_01C29C91.9E5692E0 - -	send_pictures
Yes , there were 18 this morning - I sent the resume ones to Germana , and took the rest myself .	send_resume
I could n't decide which ones to send , so I sent them all ... : - ) ( I never just take one picture ...	send_pictures
If you want to send us the completed project for review , we can do that ? Thanks , Support	send_review
it safe you have done a good job Send some more pictures How is your work going regards to your faher Amma & appa Sweet kisses to adhithi	send_pictures
* This morning I heard an outside fax coming in through the phone ( I recognized the phone number on the caller ID ) at approximately 7:30 am , but it did not arrive in my computer until around 9:10 am * I also sent myself a fax from the fax machine in the break area around 7:30 am or so , and it still has not arrived .	send_fax
( do n't say changes that cause our mobile app to break ) and send that to [PERSON] for review - eg . logo , URL .	send_review
If you could send the answers to [PERSON] and myslef - we will get it in the CGEY presentation ...	send_presentation
Please review it and if it is ok please send it immediately to [PERSON] .	send_review
When I tried calling earlier , I heard a message about sending a fax .	send_fax
We will continue to send these periodic updates to keep you informed on GolfLogix activities .	send_update_changes
If you need anything changed please send a request to helpdesk	send_update_changes
"When you 're ready to send a fax , simply drag and drop these thumbnails to your j2 Fax icon on the [LOCATION] "" Links Bar "" , and you 're done !"	send_fax
I sent over fax copy of offer letter tonight alreay .	send_fax
* Send us feedback .	send_review
The FaxStatus Form also allows you to resend a failed fax , view recipient information , view the attributes of the fax such as : date of transmission , number of attempts , and number of pages sent .	send_fax
send me your resume Om	send_resume
In response to part 1 , [PERSON] receive so much feedback -- some people sent updates , others requested more information -- that [PERSON] put together a smorgasbord of international options and search ideas for your enjoyment .	send_review
Hey [PERSON] , Could you send me over the new slides you created ( that you showed me before Zions ) ?	send_presentation
"[PERSON] - can you send me the beautiful "" Last Mile "" slide you created for the Strategy team ? Thanks !"	send_presentation
We make it possible to send photos ( MMS ) to any Internet enabled cell phone / PDA on the Market !	send_pictures
I am sending the Department Tress structure by fax soon . Thanks , Kinjal	send_fax
Will send you new images soon .	send_pictures
We agreed that I send to you 2 presentations first thing in the morning this Monday .	send_presentation
Hi [PERSON] , Can you send us the slide / info with the 5 differentiators for the message card .	send_presentation
Amit , I would greatly appreciate it if you could send me electronic versions of yesterday 's presentations ASAP so that I might share this information with some of my Partners within our FSI practice .	send_presentation
yeah send me pictures ....	send_pictures
I 'll send out an email to reschedule our group meeting .	send_meeting_request
Here 's what I sent to [PERSON] , which he has included in his e - staff presentations : * * >	send_presentation
If you are not getting the fax line , it would be grateful if you could kindly send it through email .	send_fax
and I will send out the fax .	send_fax
People sending faxes to your new number will not incur any long distance charges ( when calling from [LOCATION] [LOCATION] [LOCATION] ) .	send_fax
Can you send directions , or should I just get them from your web site ? Look forward to seeing you ! [PERSON] [PERSON] [PERSON] [PERSON] tel . ( 415 ) 472 - 7138 fax ( 415 ) 472 - 7068 acs@nbn.com	send_fax
You can always send them to me or go to Network Neighborhood > Utilitysrv1 > Board Meeting > 12 - 05 - 00 to store your presentations for the Board meeting .	send_presentation
Please send me a copy of your resume , and your private contact information .	send_resume
We need to send it out for review before the Release Notes go out with the product .	send_review
Here 's how to send your pictures :	send_pictures
Hi [PERSON] , Alaska Air sent you a SOW fax .	send_fax
I wanted to see if you could review it before I sent it . [PERSON] [PERSON] [PERSON] , We are looking forward to meet with you this Thursday to better understand your business needs and show you how our technology could help you solve them .	send_review
Please send me comments by end of day tomorrow so we can get it out for review early Friday .	send_review
We 'll review the Feedback Form as soon as you send it back and should be ready to deploy this into production after any modifications are made .	send_review
Hey [PERSON] , I have been sending out resumes and meeting with people to try and secure a new position .	send_resume
Will send update as soon as we make some progress . - NIhar	send_update_changes
After you 've set it up , send us a link to Adithi 's pictures .	send_pictures
Pl . send me ur comments .	send_review
It would be great if you could send me the slides from today 's presentation .	send_presentation
I sent my comments SATURDAY , not the following Tuesday .	send_review
Send me your feedback . thanks , [PERSON]	send_review
Can I send you my resume to forward ? Thanks .	send_resume
Just a reminder to send your slides to the appropriately names mailbox SLIDES@dci.com on ( or , of course , before ) Monday August 7th .	send_presentation
[PERSON] [PERSON] p.s . let me know if you want me to cut the photo of your dad and the others out of the Times and send it to you .	send_pictures
Good morning [PERSON] , Send me your fax number and I 'll fax the form to you .	send_fax
Hi [PERSON] , Here I am sending modified resume .	send_resume
[PERSON] , Send me your resume and lets chat .	send_resume
My outlook calendar is up to date and usually mid / late afternoons are open for me lately , so feel free to send me a meeting request ( so I wo n't book another meeting 8^ ) .	send_meeting_request
Hello [PERSON] , thank you for sending me your resume .	send_resume
RELATIVE IMPORTANCE among federal - CIVIC.COM has a MODEST LEAD in INTRINSIC VALUE and a WIDE LEAD in RELATIVE IMPORTANCE among state and local Let me know IF YOU WOULD LIKE THE DETAIL behind the above research summary points , and I will send you PowerPoint slides .	send_presentation
I 'll send you an update when I am done .	send_update_changes
Please review it before you send it out .	send_review
This is good , because now we will be able to send you photos :-) Did you get the e - mail I sent you Friday ?	send_pictures
Pl . send me your comments .	send_review
There are no change since the update I sent you yesterday .	send_update_changes
We will work to get an electronic copy ASAP , but for now all we have is a faxed copy ( 50 pages ) that I sent one copy of to [PERSON] [PERSON] .	send_fax
Hi Mr. [PERSON] , I just want to briefly ask you wether it is feasible to send us the presentations used during our Friday meeting last week .	send_presentation
I am such photo - addict ( I think because we live far away ) , so please send me more photos when you can .	send_pictures
If you would rather not send an electronic copy , a fax copy would suffice .	send_fax
They are using four slides that I sent to them last week .	send_presentation
Valent , Thank you for sending your resume .	send_resume
It 's also a 30 min presentation , followed by 15 min Q&A. btw , did [PERSON] send you the allNetDevices info ?	send_presentation
Several companies now offer web - based products and services that allow a presenter to send PowerPoint slide presentations to any number of people for viewing at their desks or in a meeting room .	send_presentation
If you are interested , you can send me a personal email to : aerlijma@adinet.com.uy and I will forward my complete resume .	send_resume
I need to send a presentation out via email on Monday so that [PERSON] 's staff has it before Fortunata and I call in to present it on Wednesday .	send_presentation
Send your feedback to me no later than 2:00 PM tomorrow .	send_review
Can you send me all the photos and I will rename them and organize them for you .	send_pictures
[PERSON] , Please send your resume to both prasad and me ( just reply to all ) .	send_resume
Hi [PERSON] - I wanted to send this PowerPoint presentation out to you so you could take a look at it - it might help answer any questions you have about our service .	send_presentation
We 'll send updates more regularly , and I apologize that we have n't done so up to now .	send_update_changes
I already sent the link to Debbie to review .	send_review
Once this is done I 'll send another update .	send_update_changes
I 'll send out the meeting request .	send_meeting_request
[PERSON] , Yes , please send these presentations to [PERSON] and myself and let us know when you need us to get back to you .	send_presentation
I left you a message on your cell phone this morning To confirm the meeting I sent the request for .	send_meeting_request
I just sent out the meeting request for tomorrow 's meeting .	send_meeting_request
Sending a digital photo from a camera - equipped mobile telephone should be no more complicated than that .	send_pictures
Once it is found , the salesperson clicks on the send option that faxes the material to the client 's office or sends it to their email account .	send_fax
Please send all referrals ( names , leads , resumes , everything ! ) directly to Mattmcg .	send_resume
The order of the presentations somewhat follows the PDF I sent you earlier with spontaneous observations and troubleshooting information inserted throughout .	send_presentation
I will send you an update on progress .	send_update_changes
All Please review this agenda and send me your feedback .	send_review
I 've just been putting my feet in the water so to speak and seeing what 's out there . have n't sent one resume out yet , cause I know that as soon as I do , everything will be chaotic :} plan on sending resumes out in a week once I get everything else taken care of .	send_resume
Please review it and if you have any comments let me know , I will try to fix it before sending the trainig material to [PERSON] . Thanks ,	send_review
Please review and send back your comments .	send_review
Maybe you can pull out some slides from the presentation and send it to them , but nothing important .	send_presentation
I bought a scanner to scan some photos in so when I actually get around to doing it I 'll send you some .	send_pictures
Please send resumes or referrals to fpomerantz@pomerantzgroup.com .	send_resume
R&D folks will help by creating demos and suggest slide content for [PERSON] , though [PERSON] is the overall presenter ( i.e. [PERSON] and invite engineers up to help but [PERSON] will create the overall presentation and facilitate the meeting ) -------------------------------------------------------------------------------------------------------------------------------- Rajeev will send out specifics ; please support both [PERSON] in her presentation to EMAS on Monday and [PERSON] in his presentation to AE , Marketing and SEs on Thursday .	send_presentation
If you have comments or recommendations for improvement , please send them to me or stop by .	send_review
I will send you instructions on how to join in on the Web - ex presentation soon .	send_presentation
I want to send my resume to you .. kaya [PERSON] [PERSON] [PERSON] [PERSON] [PERSON] [PERSON] ...	send_resume
I 'm such a B --- ch ! A week or so ago , I sent you my sister 's resume ... did you ever get it ?	send_resume
As flashy as Japanese cell phones are , this was something very special -- a third - generation ( 3 G ) mobile phone capable of taking and sending pictures at a blistering 64Kbps . 2 .	send_pictures
Kimberlie , would you send [PERSON] the latest -- I do n't know if you 've made iterative changes as of late .	send_update_changes
draft of my slides , sorry I 've been running behind , I 'll send you another draft later tonight . . .	send_presentation
He said no , he was sending a fax for payment info .	send_fax
"less than 20 have been updated , [PERSON] is sending out a note today to "" not "" update them ."	send_update_changes
Once you give that , I will also incorporate this change and send you all the changes by tomorrow . - Thanks [PERSON] [PERSON] .	send_update_changes
Please send me your feedback by mail .	send_review
Hello [PERSON] , Can you please review this before I send it out .	send_review
Please FedEx the original to [LOCATION] , since the fax does not seem to send clean copies . 2 .	send_fax
Also please send me an email today letting me know which of the feature meetings you attended so that I know who I can follow up with .	send_meeting_request
[PERSON] - if the reporter has to do it on Monday , I 'll immediately send a meeting request to block your calendar .	send_meeting_request
For signature , please print out and sign two originals , fax one original to : [PERSON] [PERSON] Contracts Specialist fax : 650 - 477 - 7343 Then send the two originals to [PERSON] at the following address for countersignature : Siebel Systems , Inc. 2207 Bridgepointe Parkway San Mateo , CA 94404 Please let me know if you have any questions .	send_fax
So the next step is I do some more definition and review it with you and then send it off to [PERSON] .	send_review
Check http://cm / rnd / Offline and send your feedback .	send_review
Ca n't do Mon pm Have sent a meeting maker for tues at 11.00 , let me know .	send_meeting_request
I 'll send the meeting request so it 's in [PERSON] 's calendar . :-)	send_meeting_request
If you have any friends who are from similar background and would be interested in this requirement please do ask them to send their cvs to me .	send_resume
I just sent you a link to the pictures my friend Eddie took Down there .	send_pictures
I send you this picture with all of my heart !	send_pictures
For back up purposes , I am sending the presentation to you guys as well - just in case .	send_presentation
I sent another email regarding when it will take place , and who will walk S&P through the bookmark change , please provide that info .	send_update_changes
I will send out my update .	send_update_changes
Sorry , I forgot to send you an email , but your fax should be working now and should arrive faster now .	send_fax
[PERSON] , please look at it as well , and send me your feedback .	send_review
Would one of you please send me the resumes for the Sitraka folks in R&D so I can work on an assimilation plan ?	send_resume
Cam sent an email yesterday saying she needs the presentation slides on how to approach G.M. in [LOCATION] , a current customer in net caching space .	send_presentation
Gentlemen and Ladies - Would you please send me a soft copy of your Mon . evening presentation for distribution to the Executive staff ?	send_presentation
I had hoped to send at least my presentation earlier , but the logistics associated with signing up a huge number of customers and partners claimed a larger share of my time .	send_presentation
but I can send you the presentation and our positioning statement .	send_presentation
I will send out a meeting request for that .	send_meeting_request
The LightSurf PictureMail technology , used in the phone , allows users to easily capture , enhance and send images to other phone users and to personal email addresses .	send_pictures
yes ma'am , already sent the e - mail requesting this be changed .	send_update_changes
I will send you photos .	send_pictures
I am sending it to the customer to review and we will then finalize it .	send_review
Thank you and I will send you resumes today .	send_resume
This overseas version of Sharp 's camera - equipped mobile will enable customers to take pictures with and send them directly from their phones via GSM and GPRS networks and enable them to access WAP browsing applications , the companies said . = = = = = = = = = = = = = = = = = = = = = = = = = = = = = = = = = = = = = = = = = = = = = = = = = = = = = = 5 .	send_pictures
[PERSON] / Ron - Please send Germana any slides you want distributed .	send_presentation
Being able to send pictures to the Web from remote locations in real - time via the Sprint PCS all - digital nationwide network will be a valuable productivity tool that translates into a competitive advantage for businesses with a highly mobile workforce .	send_pictures
I ll send pics  he looks like [PERSON]  .	send_pictures
Send us that photo -- or better yet , e - mail it -- and we 'll select the best ones to be shared with our members in our upcoming Home deliveries .	send_pictures
, please document and send me an e - mail on what changes you 've made .	send_update_changes
Please send me comments by EOB today if you need improvements .	send_review
I will be happy to send you the new slides , but I 'm afraid I will have to hold off until after the Forum -- there are quite a few new numbers that will be released at the Forum so I can not share the presentation outside the company until after the event - is that OK with you ?	send_presentation
[PERSON] , If you have received more current versions of the slide shows please send me copies .	send_presentation
please clarify - do i send the presentation or not ?	send_presentation
I will send a meeting request for you and [PERSON] . thanks again TT	send_meeting_request
Send us an email to receive a free review pack and further details on the report , MIdirectory@mobile-metrix.com .	send_review
Will send you the updated presentation when I do . [PERSON] , [PERSON] .	send_presentation
Please send your resumes to [PERSON] at the earliest .	send_resume
[PERSON] / Mark , Please send me an update on estimated time for completion for the following 1 .	send_update_changes
If your final presentation is not ready by this date please send a draft version so that your time will be reserved .	send_presentation
I 'm sending you a copy today via fax .	send_fax
Hi [PERSON] , I sent you an email a few days ago regarding rescheduling the Strategy Off Site meeting .	send_meeting_request
Can you send [PERSON] and company the presentation and copy me .	send_presentation
I 've sent several updates to [PERSON] over the past couple of weeks between sales calls and I 'll finish the last one today .	send_update_changes
[PERSON] can fill it out in the review template itself and send it to me .	send_review
Please send me your feedback by COB tomorrow .	send_review
If you would like another copy of the invoice faxed to you , please let me know via email or phone , and I will be more than happy to send it to you .	send_fax
Any way that you guys can put together a powerpoint template for us ? Also send us gifs or whatever of the graphics / photos so that we can utilize them in our presentations ?	send_presentation
"What do you think about sending the "" belly photo "" to your dad and [PERSON] ..."	send_pictures
Please send back your comments .	send_review
I will get our comments reviewed here tomorrow and send it across .	send_review
Send me a picture of you two - I 'm very curious .	send_pictures
I 'll send you an update and all call in info .. as I get it .	send_update_changes
I want to send this out to the reviewers this afternoon .	send_review
yes it 's new ; with one small change ; just send this on and say disregard yesterday 's	send_update_changes
You can send them to me in [LOCATION] , today at 011 33 1 45 63 14 11 ( room 417 ) , or you can fax to my home Thursday at 510 654 1941 .	send_fax
[PERSON] , Can you send the entire slide bundle .	send_presentation
a person makes phone calls and sends faxes .	send_fax
Do you really want me to start sending M emails with kitty pictures ?	send_pictures
I 'll send out a meeting notice for the post - mortem .	send_meeting_request
[PERSON] , Nothing has changed since I sent you the last copy two weeks ago .	send_update_changes
[PERSON] You asked me to send you a copy of my cover slide -	send_presentation
I have sent out meeting requests to all of you , so please be sure and accept it so that it appears on your Outlook calendars .	send_meeting_request
Please send all feedback back to me .	send_review
Can you send me his resume ? Thanks !	send_resume
In the future , you can send comments to jprobe_feedback .	send_review
Please feel free to send any comments on my resume .	send_resume
Please send me the meeting detail .	send_meeting_request
I am sending the email example and the slide presentation in a few moments .	send_presentation
Please take a look at the email that I sent you with the specifics so that you can see if there are any partners or competitors that you would like to sit in on prior to or after our presentation .	send_presentation
I want to send them a fax describing new status .	send_fax
Please send me your review comments as soon as possible this morning .	send_review
Let me know if you prefer for me to call you at home also if you have an updated resume please do send me one ASAP .	send_resume
B. I 'm looking for a Windows 2000 and Windows NT fax product that will let users send faxes directly from their email application ( e.g. , by typing a fax number in the To field ) .	send_fax
I used the sizes of the jpegs [PERSON] originally sent me , so I hope they are ok .	send_pictures
SHould I just list our customers / partners , or try to send the slides seperately ? L	send_presentation
You can send faxes from your computer .	send_fax
Ty , Thanks for getting back with me , I do n't understand the apprehension to sending the slides .	send_presentation
I shall send more information , if ready prior to the meeting .	send_meeting_request
I think we all keep our calendars up to date if you want to send out a meeting request .	send_meeting_request
Morning Everyone , I hope your presentation for this Friday 's Board Meeting is ready , those of you who have not yet sent them to me .	send_presentation
Hi [PERSON] , When I spoke with [PERSON] [PERSON] this morning , he asked that we send him the presentation that includes the technical presentation ahead of time .	send_presentation
This looks good , I made a couple of changes before sending this out for review .	send_update_changes
Can you please send me those presentation slides ? Thanks , [LOCATION] .	send_presentation
I keep forgetting to send resume to you	send_resume
Please send your comments on this issue .	send_review
This quarter 's news goes to me at : pete@stanfordalumni.org Please send any photos ( with a caption and indication of whether you would like the photo returned ) directly to : [PERSON] [PERSON] Stanford Graduate School of Business News and Publication Department Stanford , [LOCATION] 94305 - 5015 E - mail : gsperry@leland.stanford.edu Phone : 650 - 725 - 3241 Thanks , [PERSON] and [PERSON] ... _ _ _ _ _ _ _ _ _ _ _ _ _ _ _ [PERSON] [PERSON] Partner Austin Ventures 701 Brazos Street Suite 1400 [LOCATION] , [LOCATION] 78701 Phone : ( 512 ) 485 - 1971 Fax : ( 512 )	send_pictures
Send any comments or problems to [PERSON] or [PERSON] .	send_review
When do you think you can send a copy to me for review ?	send_review
If you have any questions or comments send feedback to me . Thanks .	send_review
- Send faxes from your PC or the web - Personalized Voicemail -	send_fax
Please review it and send it to Hideki and [PERSON] to Toshi .	send_review
I 'll send an update .	send_update_changes
chellam ... what is this da ma ... u have sent your resume like this da ma .... chella kutti please da ..	send_resume
Pls send your feedback and suggest the improvements .	send_review
Please review and send your comments so that we all have this FFE powerpoint presentaion .	send_presentation
Please send all feedback to [PERSON] . Thanks ,	send_review
This afternoon I will make changes for the new 4 tab idea & send it to you for checkin .	send_update_changes
Since I will be out this morning and to save time , feel free to send you comments to [PERSON] directly .	send_review
But , please send your comments if you have any .	send_review
Please review and send back comments by noon tomorrow .	send_review
You were going to send me a presentation next week .	send_presentation
Please send along your feedback - some good news would be great for these folks .	send_review
I believe I 've already sent my cut at the presentation to you in a prior emai ; it also resides in the marketing folder in the presentations sub - folder in an eponious file .	send_presentation
Sent you a meeting notice for me to call you tomorrow at 8 am my time , 4 pm your time .	send_meeting_request
All PLease send your feedback comments by today .	send_review
In the meantime , please send orders by fax , or email them to me .	send_fax
[PERSON] , Let me add my slides and send the whole thing back to you .	send_presentation
Pressing the Resend button notifies Fax Sr . to resend all faxes listed in the upper listbox .	send_fax
My grandmother ordered some pictures so as soon as they come in I will send you one .	send_pictures
Please send me any comments you have .	send_review
I sent these pictures to [PERSON] , too . Love , --Dad _ _ _ _ _ Get more from the Web .	send_pictures
"The Resend page allows you to resend any fax listed in the FaxStatus folder that has the status , "" Failure "" ."	send_fax
You can even send or forward faxes via email to people who do nt have fax hardware or software .	send_fax
We can make changes / additions asap , but I want to send something to show that we have n't blown this off completely .	send_update_changes
Manage your accounts , filter messages , and even send faxes via email .	send_fax
I tried to send a feedback form to request this .	send_review
Since we are under a non - disclosure , I will send the full PowerPoint presentation from yesterday when I return to my office and get high speed access .	send_presentation
Send your presentation to Marilisa so she can weave it together - put it in the right order .	send_presentation
I asked the customer to send me a Power Point presentation with the look&feel of the account balances presentation of the secure login part .	send_presentation
I 'll send you a meeting request .	send_meeting_request
Also , please send me your address as I would love to send some pictures of the two of you that I took ! Warm Regards ! alice -----	send_pictures
Can you please send me an update on how many reviews each of the documents has had , and if possible the dates you put the docs out for review .	send_review
As long as you are getting the feedback and it 's being tracked I am OK with it ( BTW , I have send one more and it has 2 issues in it ) .	send_review
[PERSON] [PERSON] , I just want to check with you if have the presentations ready so you can send those to us and we can review them before presenting at Banamex next Friday .	send_presentation
I sent the presentation .	send_presentation
If so , just send it to my direct line fax which is ( 408 ) 562 - 8022 .	send_fax
We will send an electronic presentation to your sales group beforehand and schedule a conference call to present .	send_presentation
Again , feel free to send your feedback and ideas to me at any time .	send_review
Once I get your feedback I will send them to eCal for input .	send_review
I will send out a new meeting request soon . Thanks !	send_meeting_request
In the future , Lifeminders plans to send satellite pictures for 3 G phones as the weather is occurring .	send_pictures
I have your fireman picture up at home with the last picture you sent me of the three girls .	send_pictures
I found that looking at them was so useful that I thought I 'd send you folks my proposed approach for ECS modifications to support forms in Liberate for your review before I go in and start to make changes .	send_update_changes
Please send resumes , a brief 50 - 85 word summary of your skills , and your willingness to relocate in confidence to jobs@wirelesswednesdays.com with ' jobpost ' in the subject line . _ _ _ _ _ Please send press releases , questions , comments , and feedback to info@wirelesswednesdays.com .	send_resume
All , please send me your feedback to the email I sent over to you yesturday .	send_review
Also , in a separate fax , send me copies of the last 3 invoices received for the [LOCATION] office .	send_fax
Since I have made so many changes since the last two people looked at it ( and provided excellent comments as did two reviewers of earlier drafts ) , I hope to receive comments and corrections and then send out another version .	send_update_changes
keep sending us your feedbacks .	send_review
--============_-1241330063==_ma============-- [PERSON] , I just printed out the letter , signed , and sent it to you by fax , at 08:11 pm EST .	send_fax
--------------- I think you forgot to send the minutes of meeting for the monday meeting .	send_meeting_request
I will send you a NDA , and follow that with additional material on our company , including the presentation we discussed as part of our visit to our offices .	send_presentation
Please have a look and send your comments .	send_review
Jan .. 6.04:38:16.IST.2001 - - Hi [PERSON] , I 'm sending you the resume .	send_resume
"This is not ALL my code so feel free to send me questions > try { > allGraphics = [PERSON] [PERSON] ( ) , "" / "" + accesscode + > "" /mapplet / allgraphics.jpg "" ) ) ; >"	send_pictures
Hi [PERSON] , Not sure if you check e - mail from home , but I thought I would send you my resume for reference .	send_resume
Hi there , [PERSON] sent me these presentations .	send_presentation
Can you send the contract to my office fax ?	send_fax
I noticed that she used the main fax number again , so I sent you another copy this morning to the 562 - 8100 number .	send_fax
Per our conversation , I am sending you the updated powerpoint presentation .	send_presentation
Review the applcation and send me your comments .	send_review
Where do you want me to fax or send it ?	send_fax
We sent ur photo thru mail .	send_pictures
I shall take another picture with better lighting and try sending it to you .	send_pictures
Let 's review it Monday before we send the email .	send_review
Can you add this information and send it to me to review again ? Thanks .	send_review
[PERSON] , I will update my resume tonight and send it to you tomorrow . ...	send_resume
Please send the stuff to me today and i will add it to my presentation .	send_presentation
If you guys get a chance band on it and send feedback .	send_review
I have sent the fax now .	send_fax
If we need to proceed , please have them send us the new image .	send_pictures
Please resend resume as it was not > attached .	send_resume
Please review it before send it back to mobility / sales .	send_review
If you have comments , suggestions or tips , please do not send them to me between May 11 and May 27 .	send_review
Please send me any suggestions that you have for improving the ERT .	send_review
Please look at the difference and send me your comments .	send_review
Can you please send it to me ? Can you attach a copy of the resume and the agenda for each candidate On the actual  meeting request ?  Thanks ! !	send_meeting_request
Will you be sending weekly minutes from these meetings ?	send_meeting_request
Hi there , When you have a minute , can you please send me the presentation from the company communications meeting on Friday ?	send_presentation
My calendar is open , so just send me a meeting request .	send_meeting_request
and I can fax it or send a text doc . )	send_fax
You may also want to send a second email with the presentation as a PDF .	send_presentation
[PERSON] , Can you send me the guys you were going to have the meeting with on Wed.at	send_meeting_request
Please take lots of pics and send them to me .	send_pictures
Send names of individuals running the mCommerce Workshops so you may instruct them how to update their presentations .	send_presentation
Please review and send your comments today .	send_review
Is there are a fax number where I may be able to send some of the key pages when the packet arrives ?	send_fax
I 'd like to send it to your for review before we finalize it .	send_review
Please review and send > > your comments today .	send_review
Please note , I would strongly prefer candidates send me their resume prior to talking with them .	send_resume
Please keep him in [PERSON] next time whenever you send more feedback / details .	send_review
* * As you may have noticed , we will send all interview schedules and resumes via email instead of dropping them off at your desk like before .	send_resume
[PERSON] [PERSON] to review and send comments back to [PERSON] [PERSON] . Complete by 2/9 3 .	send_review
Also , would you please send me a copy of your technical presentation or tell me where it is on the server ?	send_presentation
My advice was to send the exact presentation we delivered , and send it immediately .	send_presentation
Where did you send the fax ?	send_fax
I do n't have slides I can send you , but here 's the skinny on how we plan to address .	send_presentation
[PERSON] : were you going to send out a meeting request for today , We d 2 - 4 re : territories , quotas , resources , etc ?	send_meeting_request
Can you send us feedback ? thanks , [PERSON]	send_review
Gents , Please take a look at my slide deck for tomorrow 's sales training and send me your comments .	send_presentation
We also will need to send a 4 / c hi - res photo of [PERSON] .	send_pictures
I 'll be putting the presentation together , so please send your input to me directly , no later than Tuesday afternoon .	send_presentation
I sent your presentation yesterday , however , I do n't foresee that malcontent will object to making changes -- especially if the changes improve your presentation , right ?	send_presentation
Please send your feedback .	send_review
If he is interested , send me his resume and I 'll get [PERSON] to have the right people look at it .	send_resume
I will also send you some pictures of the boys when I get a chance .	send_pictures
Amit and I will review it with you on Tuesday morning prior to sending it to [PERSON] [PERSON] .	send_review
In the interim I propose sending his PC Expo presentation , slightly modified .	send_presentation
* When you sign up for eFax Plus , you will receive a $ 10 usage credit to use for sending faxes .	send_fax
I will send a pdf and can fax a version if you like .	send_fax
[PERSON] [PERSON] [PERSON] you send out the appt for staff meeting on Tuesday morning at 9 am ? Thanks ! --	send_meeting_request
I 'll send an update as I get more infrmation .	send_update_changes
Please review and send feedback .	send_review
We sent a faxed reminder on February 11th . .	send_fax
But pls keep sending me the meeting summaries .	send_meeting_request
Hi [PERSON] , Could you possibly send me the HP presentation you gave to American Airlines ?	send_presentation
Can you please send the features slide to [PERSON] ? Thanks , [PERSON]	send_presentation
Also could you send me a confirming email that > you received my resume .	send_resume
By the way , you can now send faxes to my > regular voice number ( 408 ) 562.8131 .	send_fax
Please send your comments .	send_review
I was going to send you powerpoint slides but figured it would be easier for you to cut / paste / edit .	send_presentation
[PERSON] could you please resend the powerpoint presentation .	send_presentation
We need to email all the sales people and biz dev ( evryone who 's attending sales training ) to send them the new presentations .	send_presentation
I have to step into a meeting , but I wanted to send this to you quickly .	send_meeting_request
I 'll send you the updates when I receive them .	send_update_changes
My whole purpose in sending this to the team is to get feedback like this .	send_review
Since this was the first meeting - I am sending the minutes - I do n't plan to do this on regular basis .	send_meeting_request
Can you please send him all the details for the [LOCATION] event and the slides ( customer version ) .	send_presentation
What can you do with the eFax Plus Upgrade ? - Send faxes while online - up to 90 % faster than traditional fax packages - Send faxes as easily as you would send an email - Capture & send any document as a fax , even Web pages , with just a few clicks - Distribute incoming faxes to designated fax numbers and/or email addresses - automatically - Access current faxes on the eFax.com servers at anytime ( includes 10 MB of free storage ! ) - Convert your faxes into editable files using the eFax OCR feature - Preview individual pages of large faxes and selectively download them Do n't Forget !	send_fax
Send us your best beach photograph , and we 'll select a few for publication in our next issue .	send_pictures
Let me know before I send in the resume .	send_resume
Please send me your presentations if you have n't already .	send_presentation
"From : "" [PERSON] [PERSON] [PERSON] [PERSON] "" < james.larrue-baulch@sitraka.com > To : "" [PERSON] [PERSON] "" < keith.ritchie@avocadoit.com > , "" [PERSON] [PERSON] "" < geoff.vona@avocadoit.com > Subject : Can RemoteControl send to fax machines ? Date : 22 Jan 2001 23:35:29 UTC Message - ID : < FC38A9406AA4D411AB62009027DE9DA501A093AC@ntmachs10-7-2-11.avocadoit.com > [PERSON]"	send_fax
Also let me know when you anticipate sending his presentation to me .	send_presentation
Also could you send me a confirming email that you received my resume .	send_resume
Send me your comments .	send_review
Heard your resume has already reached BEA before my headhunter sent it .	send_resume
Send us any suggestions in your feedback .	send_review
As soon as I have your response I will communicate with [PERSON] and arrange the meeting , including sending you an invitation to get the meeting on your calendar .	send_meeting_request
I 'll send you copies of our presentation once it 's gone through internal review . Thanks ! ! ! !	send_presentation
I have sent so many resumes and even attended some job fairs , still no luck .	send_resume
I will send an update later . Regards , [PERSON] [PERSON]	send_update_changes
I will send you the presentation . Regards , Helen	send_presentation
fyi - I sent the presentation , excluding slides 21 - 25 , to be included in the conference cd .	send_presentation
I ca n't stress the importance of a review cycle enough when sending information out to customers .	send_review
The attached ppt includes all the slides you originally sent me ( what I submitted for the conference notebook was a subset of this presentation ) ; please let me know what changes or additions you would like to make .	send_presentation
He asked for more pharma specific presentation material -- [PERSON] , what have you sent him .	send_presentation
Please review and send me any feedback .	send_review
also please sent up a fax cover sheet to Mr. [PERSON] and both print it and email it to me .	send_fax
I am also send you the above information via fax . Thanks for your assistance .	send_fax
Hi Elba , Can you send me a copy ASAP ... fax number 416 - 643 - 4832 Thanks EK	send_fax
You guys want to review the presentation one more time before sending it over to [LOCATION] / [PERSON] ? ( it 's basically the same deck he used at the Summit4Mobility conference ) .	send_presentation
Please review and send me feedback , if any .	send_review
[PERSON] : Please send [PERSON] 's resume to [PERSON] .	send_resume
Send any questions or comments to [PERSON] and [PERSON] : [PERSON] .	send_review
Please feel free to > send > > > me your comments .	send_review
Can you please update those sections and send them back ? Thank you , [PERSON] [PERSON] .	send_update_changes
Much of J - Phone 's recent success has come from the company 's wildly popular Sha Mail service , the equivalent of Multimedia Messaging Service ( MMS ) , which allows users to take pictures with their camera - enabled phones and send them to one another .	send_pictures
Please send any comments you may have to feedback@psgroup.com	send_review
Please send me any photos via email or a website of this location .	send_pictures
Hi [PERSON] , You were going to send me a list via email for photo research , some keywords that might help .	send_pictures
Please send your comments to jeffk@responsys.com .	send_review
Please do not hesitate to send us feedback : mailto:feedback@myable.com	send_review
I think that this incorporates all of the agreed upon changes , but please review it carefully before sending it out .	send_update_changes
Either way , if you would like to send us a fax with [PERSON] 's signature on the version that you have , our fax number is +44 207 844 9503 .	send_fax
Please take a look at www.primaryknowledge.com and send me a copy of your most recent resume .	send_resume
[PERSON] and [PERSON] , [PERSON] asked me to send you both the attached two slides to include in tomorrow 's board presentation .	send_presentation
Also , if you can find a better phone picture ( with a similar front facing display screen ) - send it to me .	send_pictures
To be able to check the technical aspects of your presentation , we would like to have it beforehand and , therefore , kindly ask you to send it to the e - mail address : anne_niemi@mckinsey.com .	send_presentation
Send resumes to mcorbett@idealwave.com .	send_resume
We will send a update this evening about this .	send_update_changes
Do n't forget to send us your feedback -- click the banner on our home page or the Feedback link in [PERSON] .	send_review
The other night we talked on the hallway and you asked me to send you my resume , which I am attaching .	send_resume
Please send your information to me at your earliest convenience by fax : ( 312 ) 894 - 6390 or email : tiffanya@thgus.com .	send_fax
Also , can you please reply to the emails I sent you last week so I can get your feedback ?	send_review
I sent you all the [LOCATION] pictures .	send_pictures
Please just make comments and either write them on a hard copy and fax back or send me an email .	send_fax
[PERSON] , Could you please set up a 30 minute meeting with [PERSON] , [PERSON] , [PERSON] [PERSON] , and myself tomorrow ( Thursday ) if possible , to discuss whether Professional Services or IT needs to send someone to ThinAir Apps training ? Thanks , [PERSON] .	send_meeting_request
Have you had a chance to review the two other award ops I sent you - Mobile Commerce Awards ( deadline May 31 ) and D&T Fast 500 ( deadline May 15 ) ?	send_review
Will send you the update .	send_update_changes
but I wanted to take this opportunity to record the items I noted : * We need to send an email to sales team which describes exactly what the Smithsonian Laureate means - how can sales people leverage this accolade when with cutomers/ what words to use to descibe the award ? * Updated list of customer and the stories which go with them - what can sales team talk about safely * Send out revised list of accounts and sales people responsible * Provide central file location for the graphics of all the devices which can be used in our presentations - on sales CD and on the server PARKING LOT issues : * More info on alerts * Revised ' standard , core value ' presentation which better illustrates the use of the EP software to build Enterprise solutions ( need to change	send_presentation
Many of these products act as email - to - fax gateways and offer special address types that understand when to send information to your fax application rather than to your email application .	send_fax
so send him and me also a copy of ur > resume perhaps we can help >	send_resume
Here is what [PERSON] has sent to me as a synopsis of what his presentation would sound like .	send_presentation
Just wanted to close the loop - I sent him the presentation and reviewed it with him over the phone .	send_presentation
Scott , do n't know whether you already sent the prior powerpoint slides to [PERSON] .	send_presentation
Otherwise , if you are comfortable with the changes , feel free to send it back to Accenture for review .	send_update_changes
[PERSON] , Did you send out updates to dashboards ? Tnx , matt AvocadoIT , Your Business Everywhere !	send_update_changes
Friday , May 11 , 2001 [PERSON] [PERSON] Articles Email Bio [PERSON] [PERSON] as [PERSON] [PERSON] printer version | email this article | send feedback How is [PERSON] [PERSON] like [PERSON] [PERSON] ?	send_review
Also , if I can get your personal account where I can send his resume .	send_resume
Retransmitting the presentation that I sent previously .	send_presentation
Send me your resume .	send_resume
I also sent a meeting request .	send_meeting_request
Amit , as soon as I receive a presentation , I can send it out to the group so they may follow along .	send_presentation
I will send out an e - mail once the change is completed on Monday .	send_update_changes
Please review and send comments .	send_review
Let me know IF YOU WOULD LIKE THE DETAIL behind the above research summary points , and I will send you PowerPoint slides .	send_presentation
[PERSON] : please send me [PERSON] and [PERSON] 's resume / bio . thanks . ryan	send_resume
I already sent out a meeting request .	send_meeting_request
I will send you the document for your review before we send it out .	send_review
I 'm going to send him the presentation , but let him know that there may be some additional changes prior the mtg and to not hand it out .	send_presentation
Please review and send comments to me .	send_review
I 'll send Smart Phone comments soon .	send_review
Are there any whitepapers or technical material you could send in advance for reviewing ?	send_review
Can you send me the slide .	send_presentation
Yes , just send me the meeting detail and I will be there --------------------------	send_meeting_request
[PERSON] , Will you please send the latest install sent by [PERSON] to you to [PERSON] for UI review ? Om	send_review
When you send a fax , Fax Sr . queues the fax for processing and creates a new folder in your mailbox named FaxStatus .	send_fax
Hi All , Can someone send out the feedback forms ? Thanks , [PERSON]	send_review
I have send the fax now . [PERSON] [PERSON] [PERSON]	send_fax
Hi [PERSON] , I 'm putting together some tech slides for Sales Engineer training next week and I was wondering if you could send me some * basic * info on : - What is Liberate TV and how does it work ?	send_presentation
[PERSON] sent the presentation , I gave a call to see if we can have the discussion today .	send_presentation
I 'll also send you some comments on the phone today or tommorow .	send_review
I 'd like your review prior to sending it out to HR .	send_review
Hi [PERSON] , Just wanted to check in with you on the slide presentation I sent you .	send_presentation
Also , I think [PERSON] sent you a description of a black dress we have ( unfortunately we do n't have a picture ) .	send_pictures
You can just send it in an outline format , or in any way , and I will put it in the presentation .	send_presentation
We 'll send back comments in the a.m.	send_review
I will send a powerpoint presentation to you next week .	send_presentation
Hi [PERSON] , Please send us a copy of the presentation Venk showed us on Friday .	send_presentation
For example , an insurance claims adjuster could visit a home damaged by a tornado and file the images on the spot by taking photos on a digital camera , connecting their camera to a Sprint PCS Internet - ready Phone , and sending the images to the insurance company 's Sprint PCS - hosted Web site .	send_pictures
If someone could send a meeting request so I can put it in my calendar that would be great ! ! ! ! ok thanks .	send_meeting_request
Hi [PERSON] , Can you send the other pictures that we modified .	send_pictures
So you can remember what I look like I sent you a recent picture of myself .	send_pictures
I sent off my resume ...	send_resume
[PERSON] [PERSON] is so extremely busy that I very much doubt that he even noticed we never sent the presentation .	send_presentation
I hope to send you more resumes today .	send_resume
Hello [PERSON] , [PERSON] and [PERSON] , Please review my attachment and let me know your feedback before I send it to HR and [PERSON] .	send_review
I want to send this out asap with any changes incorporated if necessary .	send_update_changes
I wo n't make any more updates until tomorrow morning when you send it back to me .	send_update_changes
I can send you the presentation that you 've seen in print , in order to send the technical presentation as well , I would like to ask if you can review and signed this NDA .	send_presentation
Hi [PERSON] , I have briefly reviewed the rel1_final_jen that you sent back to me yesterday , thanks very much .	send_review
Please send them my way when done , the sooner the better as I am looking to have the final slide presentation done no later than Monday .	send_presentation
I 'll send more recent pictures later this week .	send_pictures
If you have not already given me your comments , please review this document * instead of * the Demo Agreement that I sent out earlier .	send_review
Hi [PERSON] , My wife asked me to send you the attached pictures of the interior of our townhome . Regards , J.V.&M. Property Holdings Inc. [PERSON] [PERSON]	send_pictures
FlashPoint 's Photivity  end - to - end digital imaging platform will provide a solution for business customers to send images from the point of capture to the Internet , using a digital camera connected to a Sprint PCS Internet - ready Phone .	send_pictures
I hope that you can send me any pictures of them .	send_pictures
[PERSON] , Could you please send the HP seminar presentation slides to [PERSON] [PERSON] at HP for Georgia Pacific .	send_presentation
I was n't able to document my feedback today , however I 'll try to send it tomorrow .	send_review
I will send you the details of the meeting .	send_meeting_request
Anyway , we shall follow your review and send the final pages at the earliest .	send_review
I expect 8 Net App sales people on the call , [PERSON] , [PERSON] , one of you two , and perhaps myself .. Will be sending out a soft copy of a ppt presentation to all and then dialing into Cams set con call for review .	send_presentation
[PERSON] : I will send you a review .	send_review
This stuff is 6 months out and so the best option is to send you the presentation and walk you through that .	send_presentation
Hi [PERSON] , I am sending you a resume of [PERSON] [PERSON] .	send_resume
I 'll send you some slides , too .	send_presentation
After having the conversations with the GM(s ) ( the week of Feb 19 ) , I will send you an update .	send_update_changes
If you have some time , please take a look at this & please send any suggestions you have on revising it to me by responding to this e - mail .	send_review
I will review this more now and send feedback .	send_review
Please send the slides on the following topics : Profesional Services ( App Dev , Maintinence , Mentoring , consultatinon , etc)- [PERSON] with input from [PERSON] [PERSON] [PERSON] [PERSON] [PERSON] [PERSON] [PERSON] [PERSON] [PERSON] [PERSON] [PERSON] ( App Maintainence , UI design , etc ) - Divakar When we collate the presentation we may group the services of the IDC with PS so that it is not visable to the customer where the services are performed .	send_presentation
[PERSON] and [PERSON] , I 'll send you our PR presentation ( fully detailed with dates / budgets / tour ideas , etc . ) tomorrow morning .	send_presentation
[PERSON] , Can you send me the latest version of the presentation ?	send_presentation
Please review this document and send your feedback by end of tomorrow ( 11/29/2001 ) .	send_review
Otherwise , send all feedback to me via e - mail .	send_review
Would it be possible for you to send the presentation via email so that I can forward it on ? Thanks again , [PERSON] -- [PERSON] [PERSON] Applications Manager AvocadoIT	send_presentation
[PERSON] , can you please update me when you think these changes can be made along with the relevant scripts ( I had sent you the list earlier ) Thanks Rajeev	send_update_changes
I will be sending the CJ at end of day , so I 'll need comments in next couple of hours .	send_review
Please send me any and all feedback regarding these documents .	send_review
That said , if you feel comfortable making changes per the drafting notes to you and removing those drafting notes , feel free to do that and send it on to Accenture in the interest of time .	send_update_changes
[PERSON] , I 've sent the meeting based upon your calendar .	send_meeting_request
To ADVERTISE in these state guides , contact [PERSON] [PERSON] at 818 - 548 - 9780 or chris_hempel@fcw.com . Let me know IF YOU WANT THE DETAIL behind the above research headlines , and I will send you PowerPoint slides .	send_presentation
Please send me your comments if you feel otherwise .	send_review
Send your comments or bring them to the meeting .	send_meeting_request
However , 2.5 G tech should have gotten some penetration , enabling users to send images and text - more than enough for powerful B2E applications .	send_pictures
"A demonstrated ability to think like a business owner , problem solve , work effectively with engineers , and create new products - Excellent communication skills - Experience & comfort with financial analysis and spreadsheets - Willingness to roll up sleeves and "" do whatever it takes "" - An MBA or equivalent from a leading school highly desired - Background in health insurance or insurance a plus , but not required Interested candidates ( no headhunters ) should send resume to [PERSON] [PERSON] at thi@ehealthinsurance.com ."	send_resume
Please send your resumes Mr. [PERSON] [PERSON] on 3745051 . Thanks , [PERSON]	send_resume
and I 'll send you the jpegs .	send_pictures
[PERSON] , Can you please send out a meeting request with time and dial - in ph # for this meeting ?	send_meeting_request
I 'll send his resume after I do some editing ...	send_resume
I was wondering if you could send me a copy of your resume .	send_resume
I will send out another notice on the actual meeting time .	send_meeting_request
I 'll send you an update once we determine what we can finish .	send_update_changes
He was a little flustered after sending Marilisa three faxes this morning with no response .	send_fax
Sorry for late to send you the mobile picture that I took at [LOCATION] .	send_pictures
No need to send the fax , just be sure to write down the tracking number .	send_fax
[PERSON] , I need a scrubbed presentation from you , which gets the marketing across with all the right product names Between [PERSON] and [PERSON] , I need one of you to be the primary relationship owner here , so send her an email thanking her for the meeting , fax her the NDA signed by me , two copies , of which she needs to return one to me .	send_presentation
Please send your feedback to Om and myself .	send_review
Send me mail with updates today . Thanks .	send_update_changes
[PERSON] , can you also send me the powerpoint presentation with product information in it to forward to her .	send_presentation
Hi [PERSON] , I asked regarding sending you the roadmap slide .	send_presentation
most likely will only send just the one slide with the change on it .	send_presentation
And please send pictures .	send_pictures
Please review this document and send your comments .	send_review
I will send the updated one when I get it from [PERSON] tomorrow .	send_update_changes
If you have any questions / feedback please send an e - mail to : nettalk@sun.com	send_review
So , I have asked [PERSON] to send you the presentation .	send_presentation
As people fill the gaps , we will send you updates .	send_update_changes
Here 's some more really cute pics but [PERSON] wants to send them later with a letter to Rosa & JC ... : )	send_pictures
Most recently , you sent a fax of the language we requested with one modification .	send_fax
Send me a note if you want to change the primary / secondary reviewers .	send_review
[PERSON] , I gave you the originals , can you just stick it in the fax machine and send it to them at the other # ?	send_fax
Send your comments to me asap .	send_review
I will send you updates each day on the progress I have made to keep our communication clear and open .	send_update_changes
I am going to send you the Powerpoint presentation in case we need it , otherwise the only thing I 'll need you to have available on the webex is the emulator and the demo web site .	send_presentation
I would appreciate if you could please send me the completed feedback form in the future .	send_review
If you have changes / adds / additions that are needed to the website please send them to [PERSON] [PERSON] and he 'll catalog them .	send_update_changes
Cam wants to have a rep call and send him some presentation slides ( ASAP ) on how we would approach GM .	send_presentation
[PERSON] , can you suggest a time that works for you and send meeting invitations ? ? ?	send_meeting_request
Let me know if you still want me to send a reply or if this was for presentation purposes only .	send_presentation
[PERSON] [PERSON] asked me to send you this presentation .	send_presentation
The number list on the contact was for a fax , so I sent a fax .	send_fax
I will send you a powerpoint slide once Venk 's admin .	send_presentation
I will send an update when I make some progress .	send_update_changes
I thought I had already sent you my feedback .	send_review
My cell phone got shut off and it looks like maybe my fax did n't get processed by Sprint long ago ( the form you gave me that I sent to [PERSON] ) .	send_fax
thanks [PERSON] . please send me your presentation upon completion .	send_presentation
Send me your questions & comments [PERSON] [PERSON] [PERSON]	send_review
Can you please send this resume to your HR ? < < resume.doc > > Thanks Jyothsna [LOCATION]	send_resume
"From : "" [PERSON] [PERSON] "" < madhava.gullapalli@avocadoit.com > Hi [PERSON] , Please sign the attached time sheet and also fax it to 408 - 562 - 8100 . Please acknowledge this e - mail when you are sending the signed fax copy so that i can collect at once ."	send_fax
Send the picture with [PERSON] and we will send it back .	send_pictures
Please send your resume and I 'll forward to appropriate people .	send_resume
As soon as I receive it , I will fax it over to you and send you a confirmation email .	send_fax
I will send the update later tonight OR send a note if none .	send_update_changes
Please send [PERSON] feedback if you have any . Srik	send_review
[PERSON] had sent the meeting request out for me and I ca n't update to send to you .	send_meeting_request
Technologic sent me a fax today reminding me that the photograph needs to be sent right away .	send_fax
Please send feedback to [PERSON] [PERSON] .	send_review
[PERSON] , I just used the format of the slide that you sent over from [PERSON] .	send_presentation
The meeting request that I sent on Tuesday will be the follow up meeting not the initial meeting .	send_meeting_request
I will update and send another mail including the taks for the whole 2002 .	send_update_changes
Please send me any comments that you might have .	send_review
Please review , I 'll be sending out note to discuss .	send_review
The SendFax Form also includes a check box that instructs [PERSON] [PERSON] [PERSON] to render the fax and send it back to you for previewing .	send_fax
Have a great honeymoon and please send us photos .	send_pictures
To send us any feedback that you might have regarding improvements in its usefulness to you and your team , please use the E - mail Feedback links found throughout the Exchange .	send_review
( I 'm gon na try to find your resume on my hard drive -to see if I still have it so I can send it to [PERSON] . )	send_resume
We need a fax number to send these to .	send_fax
Please review and send ur comments .	send_review
She needs to be sent diagrams ( powerpoints ? ) of the setup we have including how we do business ( i.e. wireless gateways , etc ... ) that presentation would be great that you have .	send_presentation
i am a believer in sending the a - team to decision maker meetings .	send_meeting_request
Please send feedback .	send_review
Assuming this meets with your approval , would it also be possible for you to send me a copy of the slide ?	send_presentation
[PERSON] will be sending copy of [PERSON] 's presentation ( [PERSON] 's boss who will be sharing podium with [LOCATION] ) this evening .	send_presentation
Send resumes ( or questions ) to linda_liu@allegis.com and I will forward it to the appropriate person or feel free to call at 415 - 355 - 5823 .	send_resume
if you prefer , you can send just your update via email to me , [PERSON] and [PERSON]	send_update_changes
Please send any feedback , comments or edits to [PERSON] and/or [PERSON] .	send_review
I am sending you the updated slides for the offsite meeting .	send_presentation
I will read this over the wekend and send you my comments .	send_review
Please feel free to send me any corrections or if you disagree .	send_review
I have gone through these changes with [PERSON] , and am sending the revisions to him concurrently .	send_update_changes
Let me know when you 've scanned the presentation , and I 'll send it along with the collateral , press release , etc to [PERSON] .	send_presentation
Please send me any changes , additions , or deletions to the minutes and/or action items as required .	send_update_changes
They will send representative sales materials and powerpoint presentations to better understand their positioning and their platform . 5 .	send_presentation
If you have comments please send them my way and I 'll incorporate them into my feedback .	send_review
[PERSON] [PERSON] , the centre manager , is in the process of preparing the appropriate invoices and will send them to Mr. [PERSON] 's attention by fax once they are completed .	send_fax
"If we want to send the "" we are viable for the long run "" , we 'll need a piece that says it . 6 ) Standard presentations ."	send_presentation
Must be all those jpg 's [PERSON] sends me of himself ... [PERSON]	send_pictures
"Ideally I should have edited it before sending it out because it is really just "" minutes "" of a meeting ."	send_meeting_request
Please test it out and send me your feedback by the end of business on Thursday .	send_review
They have told us to hold off on sending additional resumes , but that could change .	send_resume
Please feel free to make any changes you care to , and then send it back to me .	send_update_changes
I 'll send them this feedback again .	send_review
Yer sent me the meeting notice for 10:00 .	send_meeting_request
If you have comments regarding this publication , please send feedback to sunoneinsider@sun.com .	send_review
I 'd like to review this document when it is done , please send me an email .	send_review
[PERSON] , I 'll send you a document in a short while which would describe in detail the Website changes which will affect us .	send_update_changes
Can you send me some of your suggestions please .	send_review
If there are no more changes - this is what I 'm sending later today .	send_update_changes
I did send your resume to few companies I knew .	send_resume
Hello [PERSON] , Please send me the resumes for all new hires , VP or higher level .	send_resume
Please feel free to send comments my way .	send_review
I 'm working on a presentation now and my goal is to send this out to our sales people after meeting with [PERSON] [PERSON] [PERSON] tomorrow to see if the requirements need to prioritized differently .	send_presentation
[PERSON] - would it be possible to have you send Venk 's presentation from yesterday to [PERSON] [PERSON] and [PERSON] [PERSON] ( in [LOCATION] ) as they missed it ?	send_presentation
Ricardo , Could you please send me any images that you will be referencing in the online application so I can use them to create a similar look and feel for the sync version .	send_pictures
Re . meeting with [PERSON] Do , I 'm open to this , but I would suggest he first sync up with the folks within Net App since we 've already had multiple detailed discussions with them , and then have him send us an agenda of what he 's looking for from another meeting with us .	send_meeting_request
If you would like a picture , I can send you one , just say the word!:- )	send_pictures
I did receive the two faxes that [PERSON] holder sent , however it may Take a while before you get reimbursed since [PERSON] wants original receipts .	send_fax
I 'd like to be very specific about a review/ feedback process on the documents with them and let them know what is to be expected - how are they going to send their comments to us ?	send_review
Let me know if you have any comments before I send it over .	send_review
Can you review the functionality and send me the feedback so that it helps me in fixing the issues if any before review .	send_review
Please feel free to send you comments or criticisms .	send_review
I 'll go ahead and send out a meeting request .	send_meeting_request
If that 's the case , I would appreciate it if you could > send me an e - mail to signal me to check the fax machine .	send_fax
We will await your fax and instructions on where to send our signature pages .	send_fax
Can I fax them to you and send the original ?	send_fax
Will send you more updates later today if there are any more .	send_update_changes
I will send you email also once this change is delivered .	send_update_changes
We are constantly trying to improve Unimobile for you , so please feel free to send us your recommendations , suggestions or complaints anytime at feedback@unimobile.com .	send_review
I sent the meeting request !	send_meeting_request
Please review and send Amit and myself your comments .	send_review
Please send comments by end of day . thanks , [PERSON]	send_review
We need a fax number to send the signed copy .	send_fax
please review and send comments to yuyu .	send_review
What we typically do before having a formal presentation is to ask for any information that you would like to send over to us on your services .	send_presentation
I will send you a fax nmber.before that , can you tell me how long is the $ 40 promotion valid .	send_fax
Please review the slides and send me your feedback .	send_presentation
Digita Post runs inside the camera and lets users send e - mails that incorporate text , sound and images using a data - enabled cellular phone , without the need for a computer . http://www1.internetwire.com/iwire/iwpr?id=7659&cat=te 20 .	send_pictures
Please send me pictures via email .	send_pictures
Mr. [PERSON] , [PERSON] [PERSON] wanted me to send you directions to our office for your meeting with him tomorrow , Thursday , July 20th at 7:30am .	send_meeting_request
This Week 's PR Tip One tip each week , to help you get more press coverage Want an alternative to an expensive press tour ? Follow this unique idea from Timberly Morrison of Clipper Ridge Communications of Half Moon Bay , [LOCATION] : Send your PowerPoint presentation to reporters and schedule a conference call between the reporter and your client .	send_presentation
BTW , could you bring some of [PERSON] ' pictures so [PERSON] ' could send them to chu ' Pho`ng	send_pictures
In this case I 'll send you the updated images .	send_pictures
Do you want me to send you my resume ?	send_resume
I want to get into Business Development and was wondering if you could send my resume to your contacts .	send_resume
I want to make a few minor changes and then will send you the final .	send_update_changes
I tried sending you this with the pictures but Yahoo rejected it so I 'm re - sending without the pics .	send_pictures
... sent you a fax :-) .	send_fax
I have sent out meeting requests for participation .	send_meeting_request
Original Message ----- From : [PERSON] [PERSON] To : ' [PERSON] [PERSON] [PERSON] Sent : Tuesday , November 21 , 2000 7:44 AM Subject : RE : We have tried to send fax to this number for three days now and have not been successful .	send_fax
In the interest of moving this forward , I am sending this to you without the full benefit of an internal review .	send_review
Can you please send me the meeting minder again in hopes that it might appear on my calendar ?	send_meeting_request
Would you please review & bless this since Sales have requested that they 'd like to send this to the customer by the end of this week .	send_review
I would hate to send free , hot pictures to people that do n't like them .	send_pictures
The file I sent you yesterday , Attack . PPS , is a PowerPoint Show ( an automated PowerPoint slide presentation ) .	send_presentation
[PERSON] , I am sending the resumes to you as I am going through my 500 some odd emails .	send_resume
Otherwise send your comments to [PERSON] and [PERSON] only .	send_review
Would it be possible for you to send the form by fax ?	send_fax
Please approve and I will send it to [PERSON] along with [LOCATION] and [PERSON] 's pics .	send_pictures
Hi [PERSON] and [PERSON] , it was really great to saw the baby , thank you very > much for sending us the pictures and the video .	send_pictures
I would like to send [PERSON] and [PERSON] an update before COB tomorrow , even if we do n't have a solution .	send_update_changes
Send a resume to Proteus at jobs@proteus.com . _ _ _ _ _ ABOUT | CONTACT | PRESS | PRIVACY POLICY FierceWireless.com National Press Building Suite 2005 [LOCATION] , DC 20045 phone 202 302 2180 fax 202 318 0837	send_resume
Please send us your comments or ideas .	send_review
Hi Dan- As soon as I get the call - in number from our phone person , I will send out the meeting request .	send_meeting_request
Can you send [PERSON] 's presentation and we will put something together .	send_presentation
I asked [PERSON] if he could send me an email with those changes we discussed .	send_update_changes
You gon na send me your resume ?	send_resume
I have sent you my resume .	send_resume
I 'll fax and send it Thanks , Uli .	send_fax
As always , we love to hear from you , so send along your feedback and comments .	send_review
Dear [LOCATION] I have attached the resumes of the following candidates ( [PERSON] had sent these out , but I believe you could not retrieve them)- 1 .	send_resume
[PERSON] , I know that you are receiving updates from others re : the slide sets for sales training so rather than integrating my updates into an outdated slide set , I am sending you the entire updated SUN SLIDES so that you can just drag and drop them into your most recent version . Regards , Shawn [PERSON] [PERSON] AvocadoIT , Inc. 3231 Scott Blvd [LOCATION] [LOCATION] , [LOCATION] 95054	send_presentation
Please send your comments to : feedback@planetintra.com Please send comments and suggestions for The Planet newsletter to : news@planetintra.com For unsubscribe information , please see bottom of newsletter .	send_review
I 'll send you a draft of the MRD prior to the meeting .	send_meeting_request
I showed R&D the prototype I had built as it was easier for me to explain , but did mentioned that you guys were expanding it to add more functionality ( send fax as well as a much better interface ) .	send_fax
I sent a note to Darshan requesting a meeting to discuss next steps and the schedule .	send_meeting_request
ok , obtain the slide from [PERSON] , put it into your presentation and send it to quote.requests@gartner.com for approval .	send_presentation
Mon , 15 Apr 2002 04:44:17 -0700 Message - ID : < FC38A9406AA4D411AB62009027DE9DA50301AC9B@ntmachs10-7-2-11.avocadoit.com > X - Mailer : Internet Mail Service ( 5.5.2653.19 ) Hi [PERSON] , I asked [PERSON] guys to send a fax again on monday so if you receieve please fax it to 91 - 40 - 3357871 asap .	send_fax
[PERSON] , [PERSON] [PERSON] [PERSON] review and send me your comments .	send_review
Team Look into this and send me your feedback ( start from TASK ID 58 ) .	send_review
And as you make changes , please send an update to all .	send_update_changes
i will send off an email to get an update .	send_update_changes
[PERSON] [PERSON] ( the client partner ) wants to see the presentation that you sent me ( Thank ! ) and wants to call you tomorrow during the day ( probably end of the morning ) .	send_presentation
[PERSON] , [PERSON] , Could you send me the presentations ( status updates ? )	send_presentation
I 'll send out a meeting request for later this week .	send_meeting_request
Perhaps you can send some photos if available .	send_pictures
I will be making some changes and additions and then send them back to you .	send_update_changes
SendFax Form The SendFax Form is a customized Outlook form that enables you to send faxes from your mail client .	send_fax
Hi , Do you have a fax number that I can send you on offer ? Look forward to your joining the company .	send_fax
Send your comments / feedback asap .	send_review
Can you please send me the feedback document ? Thanks , [LOCATION] .	send_review
[PERSON] and [PERSON] , [PERSON] [PERSON] contacted me and asked if he could be added to our reviewers list ; I sent him the course modules and here is a very positive remark : I was able to go through this module in 3 hours .	send_review
When you send me your feedback , please mention which category the task falls under ?	send_review
I will compose the mail tonight ; get some eyes here to review it ; then send it to [PERSON] and you .	send_review
I think [PERSON] is going to send out an update on this .	send_update_changes
* Highlight all new entries in Red font so I can easily pick out your updates Please send me your updates by 1 pm on Wednesday .	send_update_changes
I 'm taking my laptop with me , so I will show them the recent photos you sent me and your website .	send_pictures
You 're the best - send it to 672 clipper st No . 2 [LOCATION] [LOCATION] , CA 94114 -- [PERSON] [PERSON] [PERSON] [PERSON] - email ( 415 ) 430 - 2160 x4130 - voicemail / fax ----	send_fax
I will not be sending this presentation ( as backup ) out to any of the Interwoven reps .	send_presentation
I will send our current slide sets in a separate email .	send_presentation
I 'll send it out for your review .	send_review
The combination of these two products allow users to send faxes directly from any Microsoft Windows application on their PCs as reliably and easily as printing to a network printer , confirming that intelligent fax boards are the most obvious choice for small businesses .	send_fax
We will send you the presentation when finalized .	send_presentation
Even If you have not made any changes , send me e - mail indicating the same .	send_update_changes
We do , but they may not be live in time for [PERSON] 's meeting tomorrow ; I sent the Palm emulator so that they have something in front of them .	send_meeting_request
Please send your comments Thanks [PERSON] [PERSON] .	send_review
Please send your comments on this .	send_review
Pls send it to my home : fax 905 845 2706 or my home email :	send_fax
To expedite us sending you a hardcopy of the presentation , we request that you sign and return an NDA ( via fax ) .	send_presentation
If there is any other information that I should have just send me an email and I 'll include it all in the meeting .	send_meeting_request
If you have already developed slides to position our i - Mode offering , would you please send them to me ?	send_presentation
How about I send you the feedback in an e - mail by tomorrow morning ?	send_review
"On 6/5/01 11:16 AM , "" [PERSON] [PERSON] "" < JMcNeely@avocadoit.com > wrote : megan ; ping me if i am missing anything . also let me know when you send me a fax i will next get the design feedback to you ."	send_fax
[PERSON] , When can you send the images today ?	send_pictures
I was going to talk about this tomorrow but I think it is urgent enough ( reviews are going on today ) that I send this out now .	send_review
[PERSON] , Please review and send back you comments by tomorrow ( 12th ) .	send_review
Guys , I ca n't believe I 'm the first one to send around pictures .	send_pictures
"From : "" [PERSON] [PERSON] [PERSON] [PERSON] "" < james.larrue-baulch@sitraka.com > To : "" [PERSON] [PERSON] "" < keith.ritchie@avocadoit.com > Subject : RE : Can RemoteControl send to fax machines ? Date : 24 Jan 2001 15:23:55 [PERSON] [PERSON] [PERSON] [PERSON] [PERSON] : < FC38A9406AA4D411AB62009027DE9DA501A093A6@ntmachs10-7-2-11.avocadoit.com > In - Reply - To : < 002601c084e4$14f6c360$0200a8c0@frick.abstratica.com > How ?"	send_fax
""" In the past , you did it via a call center or you sent faxes , "" says [PERSON] [PERSON] , operations manager at National Transportation of Sault Ste . [PERSON] , [LOCATION] ."	send_fax
Stuart ; Could you please send me your resume so we can write a bio for your review for the website .	send_resume
i 'll send you a meeting request .	send_meeting_request
[PERSON] , It should be alright for you to skip this meeting as long as either there is someone else from your group representating your opinion or you send me your comments by email today .	send_meeting_request
Send [PERSON] and myself your feedback please .	send_review
Please send me the feedback by the end of the day today .	send_review
Could you please send me your fax number so I can > fax you a non - disclosure > form for you to sign and bring back with you on > Monday .	send_fax
( 2 ) [PERSON] will be sending a fax , I will leave it in your office .	send_fax
We can then give you the telephone number to call on the day , and , also send you a copy of our PowerPoint presentation slides , via email , on the morning of the event .	send_presentation
Please send me an email of your objectives for this meeting .	send_meeting_request
and please cc me :-) e - mail 1 : e - mail 2 : e - mail 3 - last one : let 's wait on the belly photo , i 'm not totally comfortable sending it out yet ... love it and thanks so much ! E	send_pictures
He sent me the presentation he did for the board that I was going to give the reader 's digest once over .	send_presentation
No need to include the corporate presentation in this kit , however be sure to include the new [PERSON] [PERSON] I sent you earlier today .	send_presentation
[PERSON] [PERSON] , Can you please send [PERSON] [PERSON] the slides on SeeBeyond EAI architecture for his presentation .	send_presentation
As you know , I am under extreme time pressure , please send your feedback as soon as possible .	send_review
Please review it before I send it out to all the attendees .	send_review
You could either send me a fax or an email with a file or screen shots .	send_fax
If you are insisting on sending the slides , to [PERSON] the PR team is very happy to support you .	send_presentation
Here is what she sent me regarding the presentation : ( she is answering my question where I asked her that maybe some of you do n't want to have slides , or send the slides to her this early ): -------- If you are having just a panel discussion -	send_presentation
Share these photos online , or have Ofoto send prints directly to friends and family .	send_pictures
Please review it and send your comments .	send_review
"I will also send you a "" more traditional "" presentation ."	send_presentation
Why do nt you send the resume to me and i will pass it along . -mamta	send_resume
I can send you both the training and customer presentations for your review and suggest that you also set a time to go over both presentations with [PERSON] [PERSON] prior to the event .	send_presentation
I will send you the final one with everyones feedback .	send_review
I would am planning to send this to BEA for their review by Friday afternoon .	send_review
Staff , Who ever has NOT sent me their presentations yet , get moving , Venk would like to review them this evening .	send_presentation
Amit , I did a quick review of slides I sent you before and felt they 're generally okay when it comes to the snapshots , though I did make a few mods .	send_presentation
Feel free to send me comments , corrections , advice , etc .	send_review
I 've already sent out a meeting notice for all of us to meet next Thursday Sept 7th from 1:30 - 2:30 pm for buyoff in moving forward .	send_meeting_request
Otherwise just send your feedback directly to Jacinda .	send_review
[PERSON] , [PERSON] and [PERSON] are finishing their presentations and will send them out today .	send_presentation
The phone rings , answers , then rings again when someone tries to send a fax .	send_fax
Also can you fax me a hard copy printout or send a pdf so I can see how the line breaks should go .	send_fax
I send you these presentations in separate mails given thier size .	send_presentation
[PERSON] , can you try to get a date for this feature out of Prasad during your next meeting with him ( Note : this feature should have been listed under the E*Trade RIM bug item in the bug list file I sent you ) .	send_meeting_request
Send your comments to [PERSON] and [PERSON] this week .	send_review
Also , please send me any feedback you have at this point .	send_review
"Be sure to use the "" fine "" resolution setting on your fax machine when sending your documents for better image quality ."	send_fax
Aim p.s . Steph and [PERSON] , can you please send me any pics you have of JC , [PERSON] , Me or [PERSON] .	send_pictures
I will send the minutes of the one previous meeting we had last week .	send_meeting_request
Can you please send me a list of the meetings that you 've been asked to attend ?	send_meeting_request
Please send your updated presentation to me directly by end of day Monday at the latest .	send_presentation
Please review ( at least the first page ) and send back your comments .	send_review
I usually just send out the Take One and that s it - ya know , hold back information to get the meetings ....	send_meeting_request
They sent faxes .	send_fax
Keep sending us your comments .	send_review
In the meanwhile , please do not hesitate to send in your feedback .	send_review
I will be sending an update on that later .	send_update_changes
This is as per our discussion - please review and send your feedback ASAP .	send_review
Have you taken a look at the resume I sent you last week .	send_resume
She sent the below email prior to me giving her the correct slides yesterday .	send_presentation
I trust your judgment on the content , but please send me a copy of the presentation so that I can clean it up and format it .	send_presentation
[PERSON] , Thanks for the message , and I apologize for the fact that I have n't sent you any presentation materials as I had originally promised .	send_presentation
If you have any comments , please send them to [PERSON] before Monday evening 09/10 . Thanks , [PERSON]	send_review
If you send your presentation after 5:00pm , make sure you send a copy to Venk as well .	send_presentation
Is there a fax # where she can send the form ?	send_fax
Please send your feedback and questions to us at feedback@yourwap.com .	send_review
[PERSON] to send reviews and resumes ( done ) .	send_resume
I 'm taking my camera , I 'll send you a picture or two .	send_pictures
[PERSON] was kind enough to update our R&D aliases to be consistent with our org chart I 've used these aliases to send out this update .	send_update_changes
Please send us your feedback whenever you have the time .	send_review
"When you 're ready to send a fax , simply drag and drop these thumbnails to your j2 Fax icon on the [LOCATION] "" Links Bar "" , and you 're done ."	send_fax
We should be careful about what slides we send to her .	send_presentation
Is this something that you are handling , or do you want me to alter the presentation and send it to you ?	send_presentation
Thanks and I will try and send you picture .	send_pictures
[PERSON] can you send me the meeting info for my calendar .	send_meeting_request
Julian , Sure , I will pull together a set of slides to send you today .	send_presentation
Could you send me an email with the network directory path ( i.e. Utilityserv1 / Home / Biz Dev / etc . ) and filename for the recent EP presentations given to Accenture Toronto and [LOCATION] folks .	send_presentation
Please review the attached document and give me any feedback before I send it out to the whole company .	send_review
The call in # is 1888 859 9465 ; passcode : 436239 # Please kindly send me your presentation materials prior to this call .	send_presentation
No phone calls please ; send resume to : [PERSON] [PERSON] [PERSON] , [PERSON] [PERSON] [PERSON] , Global Practice Leader TMP Worldwide Executive Search 650 .	send_resume
Can you send faxes from it ? ?	send_fax
[PERSON] - I sent this off to [PERSON] . Will let you know tomorrow about dates and times of future meetings .	send_meeting_request
We will send you the details of the changes soon . Thanks .	send_update_changes
I hope you 've had a chance to review the email I sent you ( on 2/8 at around 4 pm your time , in case you have to dig it up in your pile of email ! ) .	send_review
This round I ask that you be very picky regarding quality and send me specifically what needs to be changed .	send_update_changes
So we have a great opportunity here - shall I send [PERSON] the usual Tech Marketing slides ?	send_presentation
We will send out notification to all those involved in the review process of the document availability on Wednesday .	send_review
Please review and send back your comments by tomorrow afternoon .	send_review
i 'm sending the presentation to Venk for his final review . for what its worth , [LOCATION] wanted me to get the additional bullet points for the ASPmodel slide from you .	send_presentation
[PERSON] will send this list to the customer today to inform him that any more changes on the site would result in the deadline being pushed back .	send_update_changes
I 'll send it to [PERSON] when you are done revieweing it . [PERSON]	send_review
( Financial Times 30 Nov 99 ) http://www.ft.com/hippocampus/q2eb792.htm CURSOR SOFTWARE VIOLATES PRIVACY , SAY CRITICS Popular software made by Comet Systems that turns a Web browser 's cursor into a cartoon character or other whimsical image is also tracking users ' travels around the Net and sending reports back to Comet 's computer network .	send_pictures
I will send out further updates as > appropriate .	send_update_changes
Please send me the revised presentation , via e - mail , with poll questions , by 9:00 am Wednesday morning .	send_presentation
Appreciate if you could take the help of [PERSON] and send me a fax to 011 91 40 3357871 .	send_fax
Young business types on cell phones , sending faxes and using email .	send_fax
[PERSON] [PERSON] [PERSON] Per your request , I am sending you the updated powerpoint presentation .	send_presentation
Pleas send questions , comments , threats , denunciations , etc . to me .	send_review
Please contact them today and fax them the changes that you sent , etc . Can you handle for me please ?	send_fax
I re - sent this meeting request because [PERSON] would like to attend whenever possible .	send_meeting_request
I will send out meeting requests to get it on your calendar .	send_meeting_request
I am sending this press release to inform you of the changes since you originally contacted us in April .	send_update_changes
If you have not sent your slides to me , please do so .	send_presentation
I will send a copy of all the slides used in todays meeting in an additional mail . [PERSON] [PERSON]	send_presentation
Please review and send me your comments .	send_review
Please send this to all HyperRAS users . = = = = = = = = = = = = = = = = = = = = = = = = = = = = = = = = = = = = = = [PERSON] [PERSON] [PERSON] [PERSON] Security and Internet Usage By now you are all aware that a change will take place on April 15 impacting all HyperRAS users .	send_update_changes
I 'll send you an update later today on everything .	send_update_changes
[PERSON] here 's the link ; if [PERSON] had any panache at all he would know that pictures persuade and would have sent the link himself	send_pictures
I will send an update regarding tomorrow 's update in the morning .	send_update_changes
I can help answer questions , send you information , and help schedule a presentation / demo meeting , should you desire one .	send_meeting_request
I did n't get a chance to send my pic so I figured > you > prolly would n't have met up .	send_pictures
If you are interested , I could send you their powerpoint presentation .	send_presentation
[PERSON] asked me to send this to you for you to incorporate in the presentation for the meeting on Wednesday from 11:30 - 1:30 PM PST at CTIA .	send_presentation
You need to send me some pictures .	send_pictures
I am introducing each of you at the beginning of the panel , can you send me 1 slide that talks about your company -- only 3 bullets points !	send_presentation
If you have any questions about any of our changes or about our privacy policy , just send us an e - mail at privacypolicy@bestbuy.com .	send_update_changes
Please review it before send it back to MC / Sales .	send_review
[PERSON] , Can you send me minutes from yesterday 's SP8 meeting ?	send_meeting_request
I had made some changes and sent it to [PERSON] the last time .	send_update_changes
I sent HR an update .	send_update_changes
hi , how can i send a fax using jsp ? kishor _ _ _ _ _ _ _ _ _ _ _ _ _ _ _ _ _ _ _ _ _ _ _ _ _ _ _ _ _ _ _ _ _ _ _ _ _ _ _ _ _ _ _ _ _ _ _ _ _ _ _ _ _ _ _ _ _	send_fax
Please send all comments by 2 this afternoon .	send_review
And no more waiting on your fax to go through  eFax does all the work and sends you a receipt for each message successfully sent .	send_fax
There are only a few weeks to go ' til summer 's last hurrah , so if you have a beach picture you 'd like to share with us , send it on !	send_pictures
Amit , Pardon me just a minute : you sent me that change at 8:30AM Friday morning and said it must be reviewed by the afternoon .	send_update_changes
I 'll collect some thoughts and send them to you and the team for comments .	send_review
Could you send a few pictures of earlier TiE Con ?	send_pictures
I need to send comments by today , so if you have any , please let me know .	send_review
Could you please send me your comments and recommendations for [PERSON] [PERSON] ? ? ? ? [PERSON] [PERSON] [PERSON] [PERSON] [PERSON] Manager Direct : 408.562.8096 [LOCATION] : 408.829 - 4796 Fax : 408.562.8107	send_review
[PERSON] , I will fax a copy of your Dental Cards right after I send this email .	send_fax
Send me an update .	send_update_changes
I also sent you a meeting request .	send_meeting_request
Please send it to me to review as soon as possible . Thanks .	send_review
You can use the slide that I sent out with the three bars to illustrate this point .	send_presentation
I will resend you a copy now to your fax : 408 - 562 - 8100 , with [PERSON] 's signature and then will forward you a soft copy .	send_fax
I 'll send an update tomorrow if required .	send_update_changes
If you took photos , please send this way :-) Take care , hugs and kisses , Your sil - etoes	send_pictures
Review and send me ur comments .	send_review
Joel will send out an update to [PERSON] and [PERSON] about this tomorrow .	send_update_changes
Can you send me an email with some details regarding the specific website changes and how they effect our work ( and the amount of rework necessary ) .	send_update_changes
Please send your suggestions / comments to [PERSON] .	send_review
Sure [PERSON] , you can send a photo to this address .	send_pictures
[PERSON] would die if she knew I was sending this picture to other people , but [PERSON] is in it , and I wanted you to see what he looked like ( as I mention him from time to time ) .	send_pictures
We will send you updates if the status changes .	send_update_changes
Can you please send us the information or the agenda for the meeting as soon as possible ? Thanks .	send_meeting_request
Feel free to send me any and all feedback .	send_review
I need your fax number so I can send you the trail info .	send_fax
Please read them carefully and if you have any questions or comments , send them to me right away .	send_review
Thanks for the resumes that you 've sent so far .	send_resume
Instead , I will be sending you and [PERSON] a resume on a consultant from Emerald Solutions who has experience with ChangePoint .	send_resume
[PERSON] will send this list to the customer today to inform him that any more changes on the site would result in the deadline being pushed back .	send_update_changes
Please send comments to me , I 'll incorporate and then post on JProbe pages .	send_review
I will be sending you a meeting request along with an agenda attached .	send_meeting_request
:O ) I was planning on sending some pictures along with this email , but my connection w/ the other computers has been interrupted , so I 'll have to send some later .	send_pictures
I am going to significantly change the emphasis before I sent it out .	send_update_changes
I always feel funny about sending out presentations ; especially to people I do n't know	send_presentation
Sign and send faxes without printing .	send_fax
I would like to work on the presentation / data more and will send it to you no later than Saturday morning .	send_presentation
> Could you please send me a soft copy of your > resume again .I will schedule > an interview this > week .	send_resume
Would you send a meeting notice ? Thanks .	send_meeting_request
Tomorrow the customer will send the presentation .	send_presentation
I sent two additional pics to [PERSON] and [PERSON] [PERSON] from IBD , though they are nothing to be proud of ... we really NEED to have PROFESSIONAL pics taken of [LOCATION] .	send_pictures
Pls send in your presentations to be included in the audience packet .	send_presentation
If you find good images from their website , can you send those also .	send_pictures
Please send your feedback to [PERSON] and [PERSON] . THanks srik	send_review
Once I get your feedback I will send them to eCal for input .	send_review
If you would please send me your fax number , I will send one right over to you .	send_fax
Once I get into the hotel , I will send over a recent Powerpoint presentation given to an Accenture audience so that [PERSON] and [PERSON] can get a sense of our messaging and joint activity .	send_presentation
[PERSON] adds one caution : Ask permission BEFORE you send the PowerPoint presentation via email .	send_presentation
I am sending you the resume I told you about .	send_resume
Can you please send it to me , and any other information , links , etc that you have that may be of use to us before the meeting .	send_meeting_request
[PERSON] , Since I could not make the marketing presentations in last Friday 's sales meeting , could you please send me a copy ?	send_presentation
Do you send the copy of resume also along with the AEC application ?	send_resume
If you have any questions or feedback for me please send me an e - mail ( nickhall@pacbell.net ) .	send_review
I am awaiting an answer from CGEY Chicago personeel before sending out the meeting request .	send_meeting_request
I 'll have my VP of Sales sign it and will fax it back to you if you can send me your fax number .	send_fax
[PERSON] , At this moment the best thing to do would be you receive the fax , then when I get back to corporate on Monday I will find a fax number for you to send the docs .	send_fax
[PERSON] She thought she had sent us the update ..	send_update_changes
you have until monday 11 am to make suggestions for change , otherwise i 'm sending as is . thanks , ryan	send_update_changes
Can you please send me the resumes ? Thanks , [LOCATION] .	send_resume
Send me all the nice naked(female ) pictures ...	send_pictures
I 'll send the meeting request .	send_meeting_request
"Please send any comments / feedback to "" PM Team "" ."	send_review
I will send you confirmation tomorrow after he has responded to the meeting request .	send_meeting_request
I will send your resume to a few EDA companies ( [LOCATION] , [LOCATION] , Cadence ) .	send_resume
Hi [PERSON] , [PERSON] [PERSON] sent a fax saying she is mailing a check today by mail .	send_fax
Will send you updates as they occur .	send_update_changes
As we discussed , I will investigate the protocol for sending out presentations .	send_presentation
Please revise and send me all comments by end of day Thursday ( the 26th ) so that we can have this finalized .	send_review
Please test and send us your feedback .	send_review
Please feel free to send comments and suggested improvements for future use to [PERSON] . Thanks .	send_review
Justin , No problem , Just send me your resume .	send_resume
Please review this and send me your feedback .	send_review
You DO NOT need to send no picture !	send_pictures
FYI Please look through these changes , if you feel they are not necessary , just provide your input and send it back to me .	send_update_changes
He is not so adorable at 2:00 a.m. when he is colicky ... I will send more pictures soon .	send_pictures
Is he sending slides to me ? Best , [PERSON] [PERSON] ( 212 ) 272 - 3190	send_presentation
I need for you to email ( jen@pepcom.com < mailto:jen@pepcom.com > ) or fax ( 561 - 731 - 5787 ) to me the completed Requirement Sheet that I sent to you awhile back NO LATER THAN FRIDAY , OCTOBER 13 .	send_fax
The fax number is ( 650)233 - 4545 to send signatures back to me .	send_fax
please plan to review it by tomorrow noon and send your comments so that we can finish that by the end of day and give to team for external review .	send_review
Please review and send feed back .	send_review
All , I will send out a meeting request as I get confirmaiton of CGEY 's travel / flight schedule .	send_meeting_request
It will take little bit time ( may be a week or 10 days ) for me to send you the resume , If that 's OK with you .	send_resume
[PERSON] , Stop screwing around and send the presentation .	send_presentation
Kindly send me your fax number so that I can fax you her renewal form > immediately .	send_fax
FYI , I 've placed any presentations you 've sent me for tomorrow 's meeting on the Utilitysrv1 > E - Staff > March > Saturday E - Staff 3 - 24 .	send_presentation
I will send an updated change request form on Monday .	send_update_changes
On the Qxprint.com website , subscribing members can send files and documents via e - mail , fax , [LOCATION] postal , or Federal Express Priority Overnight ; manage their files through editing , viewing or deleting options ; upload new files to their desktop ; edit , add or delete contact lists ; and access a history of transactions , which are automatically recorded for reviewing and auditing .	send_fax
What we are finding is that when we look at your calendars , you are available and send you a meeting request .	send_meeting_request
Please review this document and send me any feedback or additions you have and I will make the appropriate edits .	send_review
We will send each sell sheet with the photos as we are finished with them .	send_pictures
Please send her and myself email when you have the review . Thanks .	send_review
Great .. Please send me the updated version tomorrow and cc : [PERSON] [PERSON] .	send_update_changes
Users with camera - equipped handsets can take pictures and send them to other mobile users on J - phone s existing 2.5 G network . _ _ _ _ _	send_pictures
i was actually going to send you pictures of buttcracks while you were still at UUNET ...	send_pictures
[PERSON] did not send a respository so I 'm not sure if there are any changes that affect us .	send_update_changes
Send me your comments by COB tomorrow .	send_review
